8,37;19,37;19,40;8,40
33,37;44,37;44,40;33,40
15,30;16,31;15,32;14,31
37,30;38,31;37,32;36,31
25,25;25,20;28,20;28,22;27,23;26,24
